4 14
2 6
-1 8 2 1
-1 32 5 2
-1 47 9 3
-2 18 15 Health
-3 28 5 1
-3 13 14 2
-3 6 4 3
-99
###################################################
#888888888............8888888888888888888888888888#
#888888.%....8888....88888888888888888888888888888#
###888.....8888888.....888888888888888888888888888#
######_#8888888888888......########################
#......#888888888888888.....|.m.%.m...............#
#.X.####888888888888888....########...............#
#####8888888888888.......888888888###.............#
#88888888888888888...888888888888888###...........#
#88888888888888....8888888888888888888###......%..#
#8888888888888..888888888888888888888888#####.....#
#88888888888...88888888888888888888888888888#######
#8888888888...888888888888888888888888888888888888#
#88888............88888888888888888888888888888888#
#88.....#####_#######88888888888888888888888888888#
#8888888#.........i.#88888888888888888888888888888#
###################################################